#######################################
# Syntax Coloring Map For ESP8266HTTPClient
#######################################

#######################################
# Library (KEYWORD3)
#######################################

ClientHTTP	KEYWORD3		RESERVED_WORD

#######################################
# Datatypes (KEYWORD1)
#######################################

Sizer	KEYWORD1		DATA_TYPE
ClientHTTP	KEYWORD1		DATA_TYPE
t	KEYWORD1		DATA_TYPE
follow_redirects_t	KEYWORD1		DATA_TYPE
http_version_t	KEYWORD1		DATA_TYPE
client_state_t	KEYWORD1		DATA_TYPE

#######################################
# Methods and Functions (KEYWORD2)
#######################################

reset	KEYWORD2
getSize	KEYWORD2
connect	KEYWORD2
write	KEYWORD2
available	KEYWORD2
read	KEYWORD2
peek	KEYWORD2
flush	KEYWORD2
stop	KEYWORD2
connected	KEYWORD2
GET	KEYWORD2
HEAD	KEYWORD2
POST	KEYWORD2
PUT	KEYWORD2
PATCH	KEYWORD2
DELETE	KEYWORD2
status	KEYWORD2
leftToRead	KEYWORD2
leftToWrite	KEYWORD2
printTo	KEYWORD2
writeRequestHeaders	KEYWORD2
readResponseHeaders	KEYWORD2

#######################################
# Constants (LITERAL1)
#######################################

HTTP_ERROR	LITERAL1		RESERVED_WORD_2
REDIRECT_LIMIT_REACHED	LITERAL1		RESERVED_WORD_2
REDIRECT_CONNECTION_FAILED	LITERAL1		RESERVED_WORD_2
REDIRECT_UNKOWN_METHOD	LITERAL1		RESERVED_WORD_2
REDIRECT_FAILURE	LITERAL1		RESERVED_WORD_2
RESPONSE_HEADER_TIMEOUT	LITERAL1		RESERVED_WORD_2
OUT_OF_MEMORY	LITERAL1		RESERVED_WORD_2
CHUNK_HEADER_TIMEOUT	LITERAL1		RESERVED_WORD_2
CHUNK_HEADER_INVALID	LITERAL1		RESERVED_WORD_2
CONTINUE	LITERAL1		RESERVED_WORD_2
SWITCHING_PROTOCOLS	LITERAL1		RESERVED_WORD_2
PROCESSING	LITERAL1		RESERVED_WORD_2
OK	LITERAL1		RESERVED_WORD_2
CREATED	LITERAL1		RESERVED_WORD_2
ACCEPTED	LITERAL1		RESERVED_WORD_2
NON_AUTHORITATIVE_INFORMATION	LITERAL1		RESERVED_WORD_2
NO_CONTENT	LITERAL1		RESERVED_WORD_2
RESET_CONTENT	LITERAL1		RESERVED_WORD_2
PARTIAL_CONTENT	LITERAL1		RESERVED_WORD_2
MULTI_STATUS	LITERAL1		RESERVED_WORD_2
ALREADY_REPORTED	LITERAL1		RESERVED_WORD_2
IM_USED	LITERAL1		RESERVED_WORD_2
MULTIPLE_CHOICES	LITERAL1		RESERVED_WORD_2
MOVED_PERMANENTLY	LITERAL1		RESERVED_WORD_2
FOUND	LITERAL1		RESERVED_WORD_2
SEE_OTHER	LITERAL1		RESERVED_WORD_2
NOT_MODIFIED	LITERAL1		RESERVED_WORD_2
USE_PROXY	LITERAL1		RESERVED_WORD_2
TEMPORARY_REDIRECT	LITERAL1		RESERVED_WORD_2
PERMANENT_REDIRECT	LITERAL1		RESERVED_WORD_2
BAD_REQUEST	LITERAL1		RESERVED_WORD_2
UNAUTHORIZED	LITERAL1		RESERVED_WORD_2
PAYMENT_REQUIRED	LITERAL1		RESERVED_WORD_2
FORBIDDEN	LITERAL1		RESERVED_WORD_2
NOT_FOUND	LITERAL1		RESERVED_WORD_2
METHOD_NOT_ALLOWED	LITERAL1		RESERVED_WORD_2
NOT_ACCEPTABLE	LITERAL1		RESERVED_WORD_2
PROXY_AUTHENTICATION_REQUIRED	LITERAL1		RESERVED_WORD_2
REQUEST_TIMEOUT	LITERAL1		RESERVED_WORD_2
CONFLICT	LITERAL1		RESERVED_WORD_2
GONE	LITERAL1		RESERVED_WORD_2
LENGTH_REQUIRED	LITERAL1		RESERVED_WORD_2
PRECONDITION_FAILED	LITERAL1		RESERVED_WORD_2
PAYLOAD_TOO_LARGE	LITERAL1		RESERVED_WORD_2
URI_TOO_LONG	LITERAL1		RESERVED_WORD_2
UNSUPPORTED_MEDIA_TYPE	LITERAL1		RESERVED_WORD_2
RANGE_NOT_SATISFIABLE	LITERAL1		RESERVED_WORD_2
EXPECTATION_FAILED	LITERAL1		RESERVED_WORD_2
MISDIRECTED_REQUEST	LITERAL1		RESERVED_WORD_2
UNPROCESSABLE_ENTITY	LITERAL1		RESERVED_WORD_2
LOCKED	LITERAL1		RESERVED_WORD_2
FAILED_DEPENDENCY	LITERAL1		RESERVED_WORD_2
UPGRADE_REQUIRED	LITERAL1		RESERVED_WORD_2
PRECONDITION_REQUIRED	LITERAL1		RESERVED_WORD_2
TOO_MANY_REQUESTS	LITERAL1		RESERVED_WORD_2
REQUEST_HEADER_FIELDS_TOO_LARGE	LITERAL1		RESERVED_WORD_2
INTERNAL_SERVER_ERROR	LITERAL1		RESERVED_WORD_2
NOT_IMPLEMENTED	LITERAL1		RESERVED_WORD_2
BAD_GATEWAY	LITERAL1		RESERVED_WORD_2
SERVICE_UNAVAILABLE	LITERAL1		RESERVED_WORD_2
GATEWAY_TIMEOUT	LITERAL1		RESERVED_WORD_2
HTTP_VERSION_NOT_SUPPORTED	LITERAL1		RESERVED_WORD_2
VARIANT_ALSO_NEGOTIATES	LITERAL1		RESERVED_WORD_2
INSUFFICIENT_STORAGE	LITERAL1		RESERVED_WORD_2
LOOP_DETECTED	LITERAL1		RESERVED_WORD_2
NOT_EXTENDED	LITERAL1		RESERVED_WORD_2
NETWORK_AUTHENTICATION_REQUIRED	LITERAL1		RESERVED_WORD_2
DISABLE	LITERAL1		RESERVED_WORD_2
STRICT	LITERAL1		RESERVED_WORD_2
FORCE	LITERAL1		RESERVED_WORD_2
HTTP_10	LITERAL1		RESERVED_WORD_2
HTTP_11	LITERAL1		RESERVED_WORD_2
CLIENT_READY	LITERAL1		RESERVED_WORD_2
CLIENT_REQUEST_HEADER_SENT	LITERAL1		RESERVED_WORD_2
CLIENT_RESPONSE_HEADER	LITERAL1		RESERVED_WORD_2
CLIENT_RESPONSE_PAYLOAD	LITERAL1		RESERVED_WORD_2
RESPONSE_HEADER_LINE_SIZE	LITERAL1		RESERVED_WORD_2
PRINT_BUFFER_SIZE	LITERAL1		RESERVED_WORD_2
